name	relationship	relationship_value	continent
2iLabs	Open leaders	3	Africa
7amleh-Arab Center for Social Media Advancement	None	1	Asia
A Little Learning	Mozfest Facilitator	3	Europe
Access Space	Mozfest Facilitator	3	Europe
Accessnow.org	Grantees	5	North America
Accessnow.org	IHR Contributors	4	North America
Accessnow.org	Mozfest Facilitator	3	North America
Accessnow.org	OWF Host Org Applicants	2	North America
ACLU of Northern California	OWF Host Org Applicants	2	North America
Acuity Design	Mozfest Facilitator	3	Europe
African Internet Freedom Forum	None	1	Africa
Afrosoft IT Solutions	Mozfest Facilitator	3	Africa
Agape Werks, Inc.	Grantees	5	North America
agile ventures	None	1	#N/A
AHRC Digital Transformations Theme, University of Glasgow	Mozfest Facilitator	3	Europe
ai now	None	1	North America
Aletheia Foundation	Mozfest Facilitator	3	#N/A
Aletheia Foundation	Open leaders	3	#N/A
Alexander von Humboldt Institute for Internet and Society	OWF Host Org Applicants	2	Europe
Alfred P. Sloan Foundation	Funders	5	North America
All Digital	Grantees	5	Europe
Alliance for Affordable Internet (A4AI)	None	1	North America
Allied for Startups	None	1	Europe
allied media corp	None	1	North America
AlterMundi	None	1	South America
Alternative informatics association	None	1	Asia
Alternatives	None	1	North America
Althea Mesh	Mozfest Facilitator	3	#N/A
amandla.mobi	OWF Host Org Applicants	2	Africa
American Civil Liberties Union	Mozfest Facilitator	3	North America
American Civil Liberties Union	Mozfest Speakers	4	North America
American Civil Liberties Union	Open leaders	3	North America
And Also Too	Mozfest Facilitator	3	North America
APS Foundation	Funders	5	North America
Ardent Film Trust	Grantees	5	#N/A
Arid Lands Information Network	None	1	Africa
Arribada Initiative & Naturebytes	Mozfest Facilitator	3	Europe
Art 120	Grantees	5	North America
ARTICLE 19	Mozfest Facilitator	3	Europe
ARTICLE 19	OWF Host Org Applicants	2	Europe
Asociación por los Derechos Civiles	OWF Host Org Applicants	2	South America
Aspiration Tech	None	1	North America
Associació Pangea - Coordinadora Comunicació per a la Cooperació	None	1	Europe
Association for Learning Technology	Mozfest Facilitator	3	Europe
Association for Progressive Communications (APC)	None	1	Africa
Astraea Lesbian Foundation for Justice	None	1	North America
Asuntos del Sur	Open leaders	3	#N/A
Austin Free-Net	Grantees	5	North America
AZUR Développement	None	1	#N/A
Balochistan Voices	Mozfest Facilitator	3	Asia
Bangladesh Friendship Education Society	None	1	Asia
BBC R&D	Mozfest Facilitator	3	Europe
BBC R&D	OWF Host Org Applicants	2	Europe
Berkman Klein Center for Internet & Society	Funders	5	North America
BetaNYC	Mozfest Facilitator	3	North America
BetaNYC	Open leaders	3	North America
Beyond Activismo	Open leaders	3	#N/A
Big Bang IO LLC	Grantees	5	North America
Bill & Melinda Gates Foundation	Funders	5	North America
Bionode.io	Mozfest Facilitator	3	#N/A
Bits of Freedom	OWF Host Org Applicants	2	Europe
Blue Link Labs	Mozfest Facilitator	3	North America
BlueLink Information Network	None	1	Europe
BosLab	Open leaders	3	North America
Breakthrough New York	Open leaders	3	North America
Bro	Grantees	5	#N/A
Brooklyn On Tech	Grantees	5	North America
Brooklyn Public Library	Open leaders	3	North America
Brooklyn Public Library	OWF Host Org Applicants	2	North America
Buildbot	Grantees	5	#N/A
Building Beats	Grantees	5	North America
BuzzFeed Open Lab	Mozfest Facilitator	3	North America
Bytes for All, Bangladesh	None	1	Asia
Caddy	Grantees	5	North America
CAFFE (Computers Are Free For Everyone)	Mozfest Facilitator	3	Asia
Camera Libre	Open leaders	3	Oceania
Camfed International	Open leaders	3	North America
Canadian Civil Liberties Association	OWF Host Org Applicants	2	North America
Canadian Internet Registration Authority	Funders	5	North America
Canadian Journalists for Free Expression	None	1	North America
Capital of Texas Media Foundation	Grantees	5	North America
Capital One Foundation	Funders	5	North America
Caribou Digital (UK) Ltd	Grantees	5	Europe
Carto	Mozfest Facilitator	3	North America
CAST	OWF Host Org Applicants	2	North America
Catoosa County Public School System	Grantees	5	North America
Center for Democracy and Technology	Grantees	5	North America
Center for Democracy and Technology	OWF Host Org Applicants	2	North America
Center for Digital Democracy	OWF Host Org Applicants	2	North America
Center for Media Justice	None	1	North America
Center for Open Science	None	1	North America
Center for Popular Democracy	OWF Host Org Applicants	2	North America
Center for Technology and Society - Fundação Getulio Vargas	OWF Host Org Applicants	2	South America
Center for Urban Pedagogy	Grantees	5	North America
Center on Privacy & Technology at Georgetown Law	OWF Host Org Applicants	2	North America
Central New York Library Resources Council	Grantees	5	North America
Centre for Information Technology and Development	None	1	Africa
Centre for Internet and Society	Grantees	5	Asia
Centro De Cultura Digital	IHR Contributors	4	North America
Centrum Cyfrowe	None	1	Europe
CERN	Mozfest Facilitator	3	Europe
CERN	Open leaders	3	Europe
Changing Expectations	Grantees	5	North America
Chaos Communication Congress / Camp (CCC)	None	1	Europe
Charité - Universitätsmedizin Berlin, Medizinische Bibliothek, elektronische Zeitschriften	Open leaders	3	Europe
Chasing 23 Youth Empowerment Group	Grantees	5	North America
CHAYN	Mozfest Facilitator	3	#N/A
Chicago Community Trust	Funders	5	North America
chicago learning exchange	None	1	North America
Chicago Public Library Foundation	Open leaders	3	North America
Chicago Youth Centers	Grantees	5	North America
Chicas en tecnología	Open leaders	3	#N/A
ChickTech	Mozfest Facilitator	3	North America
ChickTech	Open leaders	3	North America
CIPIT - Centre for Intellectual Property and Information Technology Law	Grantees	5	Africa
CIPIT - Centre for Intellectual Property and Information Technology Law	OWF Host Org Applicants	2	Africa
Citizen Cyberlab	Mozfest Facilitator	3	Europe
Citizen Lab	OWF Host Org Applicants	2	North America
Civica Digital	Open leaders	3	Europe
CIVICUS WORLD ALLIANCE FOR PARTICIPATION INC	Grantees	5	Africa
Cleveland Public Library	Grantees	5	North America
Cleveland Public Library	Open leaders	3	North America
CodamosClub	Open leaders	3	#N/A
Code First: Girls	Mozfest Facilitator	3	Europe
Code for Nepal	Open leaders	3	#N/A
Code for Science & Society	Mozfest Facilitator	3	#N/A
Code for Science & Society	Open leaders	3	#N/A
Code is Science	Open leaders	3	North America
Code.org	None	1	North America
Code/Interactive	Grantees	5	North America
CodeMirror	Grantees	5	#N/A
CoderDojo	Mozfest Facilitator	3	Europe
Código Sur	None	1	North America
Coding Rights	Mozfest Facilitator	3	#N/A
Coding Rights	OWF Host Org Applicants	2	#N/A
collaborate knowledge foundation (coko)	None	1	North America
Collaboration on International ICT Policy for East and Southern Africa	Grantees	5	Africa
Collaboration on International ICT Policy for East and Southern Africa	OWF Host Org Applicants	2	Africa
Colnodo	OWF Host Org Applicants	2	South America
Color of Change	OWF Host Org Applicants	2	North America
comexpo cyber security	Open leaders	3	Asia
Commento	Grantees	5	#N/A
Commission on Science and Technology for Development (CSTD)	None	1	Europe
Common Cause Educational Foundation	Grantees	5	North America
Common Sense Media	None	1	North America
Communia Association	Mozfest Facilitator	3	Europe
Computer Aid International	None	1	Europe
New York City Department of Education	Open leaders	3	North America
Conservation International	Open leaders	3	North America
consumer reports	None	1	North America
Consumers Union	Open leaders	3	North America
Cooperativa Sulá Batsú	None	1	North America
Corporación Andina de Fomento (CAF)	Mozfest Facilitator	3	South America
Covenant University Bioinformatics Research Group	Mozfest Facilitator	3	Africa
Crafts Council	Mozfest Facilitator	3	Europe
Craig Newmark Philanthropies	Funders	5	North America
Creative Commons	Grantees	5	North America
Creative Commons	Mozfest Speakers	4	North America
credibility coalition	IHR Contributors	4	North America
Crowd2Map Tanzania	Mozfest Facilitator	3	#N/A
Crowd2Map Tanzania	Open leaders	3	#N/A
CryptoHarlem	Mozfest Speakers	4	North America
cryptoparty, world	None	1	#N/A
Cryptorave	Open leaders	3	South America
CTuning foundation	Mozfest Facilitator	3	Europe
CUNY School of Professional Studies Foundation	Grantees	5	North America
CyFy	None	1	Asia
Dalai Lama Center for Ethics and Transformative Values at MIT	Open leaders	3	North America
data & society	OWF Host Org Applicants	2	North America
David Thibodaux STEM Magnet Academy	Grantees	5	North America
DefCon	None	1	North America
Dejusticia (Center for the Study of Law, Justice and Society/Centro de Estudios de Derecho, Justicia y Sociedad)	OWF Host Org Applicants	2	South America
Demand Progress	Grantees	5	North America
Demand Progress	Mozfest Facilitator	3	North America
Democracy Fund	Funders	5	North America
Derechos Digitales	Mozfest Speakers	4	South America
Derechos Digitales	OWF Host Org Applicants	2	South America
Derechos Digitales	Grantees	5	South America
designswarm	Mozfest Facilitator	3	Europe
Detroit Community Technology Project	Open leaders	3	North America
Detroit Community Technology Project	Mozfest Facilitator	3	North America
Deutsche Gesellschaft für Internationale Zusammenarbeit	None	1	Europe
Digital Asia Hub	IHR Contributors	4	Asia
Digital Citizen Summit	None	1	#N/A
Digital Empowerment Foundation (DEF)	None	1	Asia
Digital Freedom Fund	None	1	Europe
Digital Grassroots	Open leaders	3	#N/A
Digital Opportunity Trust	Grantees	5	North America
Digital Opportunity Trust	OWF Host Org Applicants	2	North America
digital opportunity trust, kenya	None	1	Africa
Digital Rights Foundation Pakistan	Mozfest Speakers	4	Asia
Digital Rights Watch	OWF Host Org Applicants	2	Oceania
Digital Security Exchange	Grantees	5	North America
Digital Society of Zimbabwe	OWF Host Org Applicants	2	#N/A
Digitale Gesellschaft	None	1	Europe
DigitalMe	None	1	Europe
diplo foundation through their internet governance courses	None	1	Europe
Discourse	Grantees	5	#N/A
Disruption Network Lab e.V.	Grantees	5	Europe
Django	Grantees	5	#N/A
Django REST Framework	Grantees	5	#N/A
DNSSEC/DANE Chain Stapling	Grantees	5	#N/A
DocuBricks	Mozfest Facilitator	3	North America
DocuBricks	Open leaders	3	North America
Doscom - Dinus Open Source Community	Mozfest Facilitator	3	Asia
Doteveryone	OWF Host Org Applicants	2	Europe
Dream Touch for All	Open leaders	3	Asia
DuraSpace	Open leaders	3	North America
Dutch Ministry of Foreign Affairs	None	1	North America
E4 Youth	Grantees	5	North America
École polytechnique fédérale de Lausanne	Mozfest Facilitator	3	Europe
Editacuja & Appiario	IHR Contributors	4	South America
Educators Cooperative	Mozfest Facilitator	3	North America
Eduity, LLC	Grantees	5	North America
Electronic Frontier Finland	None	1	Europe
Electronic Frontier Foundation	Grantees	5	North America
Electronic Information for Libraries (EIFL)	None	1	Europe
electronic privacy information center (epic)	None	1	North America
eLife	Mozfest Facilitator	3	North America
Emojination	Mozfest Facilitator	3	#N/A
Endangered Data Week	Open leaders	3	#N/A
EngageMedia	Grantees	5	Oceania
enterprise center chattanooga	None	1	North America
Epicenter.works	Mozfest Facilitator	3	Europe
eQualit.ie	OWF Host Org Applicants	2	North America
Equality Labs	OWF Host Org Applicants	2	#N/A
ETER || a free/libre air-quality monitor for education & research	Grantees	5	#N/A
European Bureau of Library, Information and Documentation Associations	None	1	Europe
European Consumers' Bureau	None	1	Europe
European Digital Media Association (EDiMA)	None	1	Europe
European Digital Rights	Grantees	5	Europe
European Digital Rights	Mozfest Facilitator	3	Europe
European Digital Rights	Open leaders	3	Europe
European Digital Rights	OWF Host Org Applicants	2	Europe
Exa Foundation	Mozfest Facilitator	3	Europe
Explo	Open leaders	3	North America
explore science	Mozfest Facilitator	3	North America
EyeBeam	Grantees	5	North America
EyeBeam	Mozfest Facilitator	3	North America
EyeBeam	OWF Host Org Applicants	2	North America
eyeo GmbH	Mozfest Facilitator	3	Europe
f**koffgoogle.de	None	1	Europe
FabLabs (Netherlands)	None	1	Europe
Facing History and Ourselves	Open leaders	3	North America
Fantsuam Foundation	None	1	Africa
Fathom Beyond	Mozfest Facilitator	3	Africa
FEMNET - African Women's Development and Communication Network	OWF Host Org Applicants	2	Africa
Fight for the Future	Grantees	5	#N/A
Fight for the Future	OWF Host Org Applicants	2	#N/A
Fit Open	Open leaders	3	#N/A
Flattr (eyeo)	Mozfest Facilitator	3	North America
Ford Foundation	Funders	5	North America
Forum of Incident Response and Security Teams (FIRST)	OWF Host Org Applicants	2	North America
Foundation for a Just Society	None	1	North America
Foundation for Media Alternatives	None	1	Asia
Foundation For Public Code	Open leaders	3	#N/A
Framasoft	OWF Host Org Applicants	2	#N/A
Free Press	Mozfest Facilitator	3	North America
Free Software Foundation	None	1	North America
Free Software Foundation Europe	OWF Host Org Applicants	2	Europe
Freedom & Roam Uganda	None	1	Africa
Freedom House	IHR Contributors	4	North America
Freedom of the Press Foundation	Mozfest Facilitator	3	North America
Freedom of the Press Foundation	OWF Host Org Applicants	2	North America
Freedom Online Coalition (FOC)	None	1	Europe
FRIDA The Young Feminist Fund	None	1	#N/A
Full Fact	Mozfest Facilitator	3	Europe
Full Frontal with Samantha Bee	Mozfest Speakers	4	North America
Full Stack Toronto	Grantees	5	North America
Fundación Acceso	None	1	North America
Fundación Ciudadano Inteligente	OWF Host Org Applicants	2	South America
Fundación Escuela Latinoamericana de Redes (EsLaRed)	None	1	South America
Fundación Karisma	None	1	South America
Fundación Medialab Quito	OWF Host Org Applicants	2	South America
FutureLearn	Mozfest Facilitator	3	Europe
Genesee Intermediate School District	Grantees	5	North America
Gesellschaft für Freiheitsrechte	None	1	Europe
Girls Who Code	None	1	North America
Girls2Geeks	Mozfest Facilitator	3	#N/A
GirlsGetGeeky	Open leaders	3	#N/A
GitHub	IHR Contributors	4	North America
GitHub	Mozfest Facilitator	3	North America
Give1ProjectGambia	Mozfest Facilitator	3	Africa
Global Action Project	Grantees	5	North America
Global Action Project	Mozfest Facilitator	3	North America
Global Connect Initiative (GCI)	None	1	North America
Global Forum on Cyber Expertise (GFCE)	None	1	Europe
Global Innovation Gathering (GIG)	Grantees	5	Europe
Global Kids	Grantees	5	North America
Global Voices Online	IHR Contributors	4	Europe
Global Voices Online	Mozfest Facilitator	3	Europe
Global Voices Online	Grantees	5	Europe
Godot	Grantees	5	#N/A
Google Ideas	None	1	North America
goTenna	Mozfest Facilitator	3	North America
Gray Area Foundation for the Arts, Inc.	OWF Host Org Applicants	2	North America
GreatFire.org	OWF Host Org Applicants	2	#N/A
GreenNet	None	1	Europe
Guifi.net	None	1	Europe
HACKccessibility	Open leaders	3	#N/A
Hacks/Hackers	Grantees	5	#N/A
Hacks/Hackers	Open leaders	3	#N/A
Hamilton County Department of Education	Grantees	5	North America
HarfBuzz	Grantees	5	#N/A
Helix Arts	Mozfest Facilitator	3	Europe
Hiperderecho	OWF Host Org Applicants	2	South America
Hivos	None	1	Europe
Holla Back	Mozfest Speakers	4	North America
Holla Back	OWF Host Org Applicants	2	North America
Housing Families First	Mozfest Facilitator	3	North America
Human Computation Institute	Mozfest Facilitator	3	North America
Human Rights Watch	OWF Host Org Applicants	2	North America
HumanityX	Mozfest Facilitator	3	Europe
Icahn Institute at Mount Sinai	Mozfest Facilitator	3	North America
ICANN	None	1	North America
Information Society Project at Yale Law School	OWF Host Org Applicants	2	North America
Institute for Educational Leadership	Open leaders	3	North America
Institute for Technology and Society of Rio de Janeiro	Open leaders	3	South America
Institute of Museum and Library Services	Open leaders	3	North America
Institute of Museum and Library Services	Funders	5	North America
Instituto DEMOS	None	1	North America
Integrated Arts	Grantees	5	#N/A
InterMine	Mozfest Facilitator	3	North America
International Federation of Library Associations and Institutions	None	1	Europe
International Freedom of Expression Exchange	None	1	North America
International Media Support (IMS)	None	1	Europe
International Research & Exchanges Board	Grantees	5	North America
International Telecommunication Union	None	1	Europe
Internet & Jurisdiction Policy Network	None	1	Europe
Internet Archive	Mozfest Facilitator	3	North America
internet education foundation	None	1	North America
Internet Engineering Task Force	None	1	North America
Internet Freedom Festival (IFF)	OWF Host Org Applicants	2	Europe
Internet Infrastructure Coalition	OWF Host Org Applicants	2	North America
Internet Policy Review (HIIG)	IHR Contributors	4	Europe
Internet Society	None	1	North America
INTERNETLAB	OWF Host Org Applicants	2	South America
Internews	None	1	North America
Intervozes	None	1	South America
Invisible Flock	Mozfest Facilitator	3	Europe
Iridescent	Mozfest Facilitator	3	North America
iRights.Lab	None	1	Europe
Japan Computer Access for Empowerment (JCAFE)	None	1	Asia
Jaume Bofill Foundation	Open leaders	3	Europe
JCA-NET	None	1	Asia
Jimmy Wales Foundation	None	1	Europe
John D. and Catherine T. MacArthur Foundation	Funders	5	North America
John F. Kennedy School of Government	Open leaders	3	North America
John S. and James L. Knight Foundation	Funders	5	North America
Johns Hopkins Sibley Innovation Hub	Mozfest Facilitator	3	North America
Journal of Open Hardware	Mozfest Facilitator	3	#N/A
Journal of Open Hardware	Open leaders	3	#N/A
JSLadies	Open leaders	3	#N/A
KC Digital Drive	Mozfest Facilitator	3	North America
KC Social Innovation Center	Grantees	5	North America
Kea	Grantees	5	North America
Kéfir	None	1	North America
Kennisland	None	1	Europe
Kenya ICT Action Network	OWF Host Org Applicants	2	Africa
Kenyan Open Data Initiative	Open leaders	3	Africa
Kirklees Library	Mozfest Facilitator	3	Europe
Korean Progressive Network Jinbonet	None	1	Asia
La Quadrature du Net	None	1	Europe
LaborNet	None	1	North America
Lafayette Science Museum Foundation	Grantees	5	North America
LakeHub	Mozfest Facilitator	3	Africa
LakeHub	Open leaders	3	Africa
Lane Arts Council	Grantees	5	North America
Lane Education Service District	Grantees	5	North America
Latinitas Inc.	Grantees	5	North America
LEAP Encryption Access Project	Grantees	5	#N/A
Learn All the Time Network	Mozfest Facilitator	3	North America
Leona M. and Harry B. Helmsley Charitable Trust	Funders	5	North America
libav/rust-av	Grantees	5	#N/A
libjpeg-turbo	Grantees	5	#N/A
Libraries.io	IHR Contributors	4	#N/A
Licensed to Learn Inc.	Grantees	5	North America
Linux Foundation	None	1	North America
Linuxing In London	Mozfest Facilitator	3	Europe
LLVM	Grantees	5	#N/A
localization lab	None	1	#N/A
Loup Design & Innovation	Open leaders	3	North America
lucy parsons labs	None	1	North America
M-Lab	IHR Contributors	4	North America
MaidSafe	Open leaders	3	#N/A
Majal.org	Mozfest Facilitator	3	#N/A
Majal.org	OWF Host Org Applicants	2	#N/A
Make Works Ltd	Mozfest Facilitator	3	Europe
Makered.io	Open leaders	3	#N/A
Mama Cash	None	1	Europe
Massachusetts Digital Services department	Open leaders	3	North America
Mastodon	None	1	#N/A
May First/People Link	None	1	North America
MedCognition, Inc.	Grantees	5	North America
Media Democracy Fund	Mozfest Facilitator	3	North America
Media Democracy Fund	OWF Host Org Applicants	2	North America
Media Legal Defence Initiative	None	1	Europe
Media Matters for Democracy	None	1	Asia
Media Mobilizing Project	Mozfest Facilitator	3	North America
Media Mobilizing Project	OWF Host Org Applicants	2	North America
Meedan	OWF Host Org Applicants	2	North America
Mercurial	Grantees	5	#N/A
Met Office Informatics Lab	Mozfest Facilitator	3	Europe
Metamorphosis Foundation	None	1	#N/A
Metropolitan New York Library Council	Mozfest Facilitator	3	North America
Metropolitan New York Library Council	Grantees	5	North America
MIT Media Lab	Funders	5	North America
MIT Media Lab	Grantees	5	North America
MIT Media Lab	Open leaders	3	North America
mod_md	Grantees	5	#N/A
Modern Poland Foundation	Grantees	5	Europe
MongoDB, Inc.	Open leaders	3	North America
Motion Media Arts Center	Grantees	5	North America
Motoon	None	1	#N/A
MOUSE Inc.	Grantees	5	North America
MPower Change	OWF Host Org Applicants	2	North America
Mu Sigma Inc.	Mozfest Facilitator	3	North America
Multnomah County Library	Grantees	5	North America
Multnomah County Library	Mozfest Facilitator	3	North America
Museum of Science and Industry	Grantees	5	North America
Muslim Advocates	OWF Host Org Applicants	2	North America
Myanmar ICT for Development Organization	None	1	Asia
namibian youth for community upliftmend	OWF Host Org Applicants	2	#N/A
National Cyber Security Alliance	Grantees	5	North America
National Digital Inclusion Alliance	Mozfest Facilitator	3	#N/A
National Museum of Mexican Art	Grantees	5	North America
National Science Foundation	Funders	5	North America
Neighborhood Economic Development Corporation	Grantees	5	North America
Netflix	Funders	5	North America
Netgov	IHR Contributors	4	#N/A
Netroots Foundation	Grantees	5	North America
Netsquared	OWF Host Org Applicants	2	#N/A
Netzpolitik.org	OWF Host Org Applicants	2	Europe
NeuroTechX	Mozfest Facilitator	3	North America
NeuroTechX	Open leaders	3	North America
New America Foundation	Grantees	5	North America
New America Foundation	Mozfest Facilitator	3	North America
New America Foundation	Open leaders	3	North America
New America Foundation	OWF Host Org Applicants	2	North America
new freedome program	None	1	#N/A
New School Digital Equity Lab	None	1	North America
New York City Department of Education	Mozfest Facilitator	3	North America
New York City Foundation for Computer Science Education	Open leaders	3	North America
New York Civil Liberties Union	OWF Host Org Applicants	2	North America
New York Community Trust	Funders	5	North America
New York Community Trust	Grantees	5	North America
New York Hall of Science (NYSCI)	Open leaders	3	North America
New York Public Library	None	1	North America
Newbook DIgital Texts	Open leaders	3	North America
News Integrity Intiative	Funders	5	North America
NEXMAP	Mozfest Facilitator	3	North America
NEXMAP	Open leaders	3	North America
Next Century Cities	OWF Host Org Applicants	2	North America
NL Net Foundation (Netherlands)	None	1	Europe
Nodo TAU	None	1	South America
NonVisual Desktop Access	Grantees	5	Oceania
North Park Village Nature Center of the Chicago Park District	Grantees	5	North America
Northern Ireland Raspberry Jam	Mozfest Facilitator	3	Europe
Núcleo de Pesquisas, Estudos e Formação	None	1	South America
Nucleus Learning Network	Mozfest Facilitator	3	North America
Nucleus Learning Network	Open leaders	3	North America
NYC Mayor's Office of Data Analytics (MODA)	Open leaders	3	North America
O Foundation	Open leaders	3	Asia
Ocado	Mozfest Facilitator	3	Europe
Ogunte	None	1	Europe
Omidyar Network	None	1	North America
One World Platform	None	1	Europe
Open Austin	Mozfest Facilitator	3	North America
Open Austin	Open leaders	3	North America
Open Data Institute	OWF Host Org Applicants	2	Europe
Open Data Kit	Open leaders	3	North America
Open Forum Foundation	None	1	North America
Open Government Partnership	None	1	North America
Open Institute	None	1	Asia
Open Knowledge International	None	1	North America
Open Knowledge Maps	Mozfest Facilitator	3	#N/A
Open Knowledge Nepal	Open leaders	3	#N/A
Open Lab Games	Mozfest Facilitator	3	Europe
Open Media	OWF Host Org Applicants	2	North America
Open Rights Group	Mozfest Facilitator	3	Europe
Open Society Foundations	Funders	5	North America
Open Society Foundations - Human Rights Initiative	None	1	North America
Open Source Circular Economy Days	Open leaders	3	Europe
Open Technology Fund	None	1	North America
Open Technology Institute	None	1	North America
Open Technology Institute and Research Action Design	Mozfest Facilitator	3	#N/A
OpenForum Europe	OWF Host Org Applicants	2	Europe
OpenGov Foundation	Open leaders	3	North America
OpenML	Open leaders	3	Europe
OpenNews	Grantees	5	North America
openSNP	Mozfest Facilitator	3	#N/A
openSNP	Open leaders	3	#N/A
OpenSpeaks	Mozfest Facilitator	3	#N/A
Organization for Security and Co-operation in Europe	None	1	Europe
Our Data Bodies Project, London School of Economics	Mozfest Facilitator	3	Europe
Oxford Internet Institute	IHR Contributors	4	Europe
PAERE	Mozfest Facilitator	3	North America
PAERE	Open leaders	3	North America
Paradigm Initiative	OWF Host Org Applicants	2	Africa
Paradigm Initiative	Grantees	5	Africa
Partnership for After School Education	Grantees	5	North America
PeARS	Grantees	5	#N/A
Peer to Peer University	Open leaders	3	North America
Pell Ensemble	Mozfest Facilitator	3	Europe
PEN American Center DBA PEN America	OWF Host Org Applicants	2	North America
Pennez LLC	Grantees	5	North America
PenPal Schools	Grantees	5	North America
Pew Research Center	None	1	North America
Phaser	Grantees	5	Europe
Planet Friendly Web	Open leaders	3	#N/A
PlanIT Impact	Grantees	5	North America
Playworks	Open leaders	3	North America
Pockets Change	Mozfest Facilitator	3	North America
Pockets Change	Open leaders	3	North America
Point of View	None	1	Asia
Powered by Data	Open leaders	3	North America
PREreview	Grantees	5	#N/A
Pretty Easy privacy	Mozfest Speakers	4	#N/A
Pride Foundation	Open leaders	3	North America
Privacy Enhancing Technologies Symposium (PETS)	None	1	#N/A
Privacy International	IHR Contributors	4	Europe
Privacy International	OWF Host Org Applicants	2	Europe
Project Isizwe	Mozfest Speakers	4	Africa
ProPublica	Mozfest Speakers	4	North America
ProPublica	OWF Host Org Applicants	2	North America
PROTEGE QV	None	1	Africa
Protocol Labs	Mozfest Facilitator	3	#N/A
Prototype Fund	None	1	#N/A
Providence Public Library	Grantees	5	North America
Providence Public Library	Mozfest Facilitator	3	North America
Public Knowledge	OWF Host Org Applicants	2	North America
Public Knowledge Workshop (PKW)	OWF Host Org Applicants	2	#N/A
Push The World	Open leaders	3	North America
PyPy	Grantees	5	#N/A
Python Package Index	Grantees	5	#N/A
Quicksand	Mozfest Facilitator	3	#N/A
R Street Institute	OWF Host Org Applicants	2	North America
Radio Free Asia	None	1	North America
Rangeview Library District	Grantees	5	North America
Ranking Digital Rights	IHR Contributors	4	North America
Ranking Digital Rights	OWF Host Org Applicants	2	North America
Raspberry Pi Foundation	Mozfest Facilitator	3	North America
RaspiKidd	Mozfest Facilitator	3	Europe
Read the Docs	Grantees	5	North America
Reading and Writing Foundation	None	1	North America
Red Hat	Open leaders	3	North America
Redefining Women in Tech	Grantees	5	North America
RedesAyuda	None	1	South America
RedThread.Media	Mozfest Facilitator	3	#N/A
Reel Stories Teen Filmmaking	Grantees	5	North America
Regent Park Focus Youth Media Arts Centre	Grantees	5	North America
Renewable Freedom Foundation	Grantees	5	Europe
Renewable Freedom Foundation	OWF Host Org Applicants	2	Europe
Research Action Design (RAD)	OWF Host Org Applicants	2	#N/A
Research ICT Africa	IHR Contributors	4	Africa
Research ICT Africa	Open leaders	3	Africa
Research ICT Africa	OWF Host Org Applicants	2	Africa
Resilient Communities NYC	Mozfest Facilitator	3	#N/A
Review Board	Grantees	5	North America
Rhizomática	None	1	North America
Right to Play International	Grantees	5	#N/A
RightsCon	None	1	#N/A
RIPE	IHR Contributors	4	#N/A
Riseup	Grantees	5	North America
Riseup	Mozfest Facilitator	3	North America
Rita Allen Foundation	Funders	5	North America
River City Youth Foundation	Grantees	5	North America
Robert W Deutsch Foundation	None	1	North America
Rory Peck Trust	None	1	Europe
Rust Language	Mozfest Facilitator	3	#N/A
Rust Language	Open leaders	3	#N/A
Rust Language	Grantees	5	#N/A
Sage Bionetworks	Mozfest Facilitator	3	North America
Sage Bionetworks	Open leaders	3	North America
Science Hack Day	Mozfest Facilitator	3	#N/A
Science Hack Day	Open leaders	3	#N/A
secure scuttlebutt	None	1	#N/A
SecureDrop	Grantees	5	#N/A
See Think Make	Mozfest Facilitator	3	#N/A
See Think Make	Open leaders	3	#N/A
Seneca College	Grantees	5	#N/A
SETUP (Netherlands)	None	1	#N/A
Share Foundation	Mozfest Facilitator	3	Europe
Share the Facts	Mozfest Facilitator	3	North America
Shedd Aquarium	Grantees	5	North America
Shuttleworth Foundation	None	1	Africa
SIDA	None	1	Europe
Siegel Family Endowment	Funders	5	North America
Siroop	Mozfest Facilitator	3	Europe
Sitewards GmbH	Mozfest Facilitator	3	Europe
Sky’s the Limit Youth Organization	Grantees	5	North America
Small Media	Mozfest Facilitator	3	Europe
Smart Chicago	Open leaders	3	North America
Social Media Exchange	IHR Contributors	4	Asia
Society for Promotion of Alternative Computing and Employment	None	1	Asia
Software Freedom Conservancy	Grantees	5	North America
Software Freedom Law Center	Mozfest Speakers	4	North America
South by Southwest	None	1	#N/A
South London Rasppberry jam	Mozfest Facilitator	3	Europe
Southern African NGO Network	None	1	Africa
SPARC	OWF Host Org Applicants	2	North America
Spectrum	None	1	Europe
Speech Rule Engine	Grantees	5	#N/A
spider oak	None	1	#N/A
sproutfund	Open leaders	3	North America
Startuple	Mozfest Facilitator	3	Europe
STEAMLabs	Grantees	5	North America
STEM From Dance	Grantees	5	North America
Stiftung Neue Verantwortung	Grantees	5	Europe
Stiftung Neue Verantwortung	OWF Host Org Applicants	2	Europe
Stockholm Internet Forum (SIF)	None	1	Europe
Storj Labs	Mozfest Facilitator	3	North America
StrawberryNet Foundation	None	1	Europe
Studio MindStride	Grantees	5	North America
SumOfUs	OWF Host Org Applicants	2	North America
Sunlight Foundation	OWF Host Org Applicants	2	North America
SunPy	Open leaders	3	#N/A
sunshine foundation	None	1	North America
Sweet Water Foundation	Grantees	5	North America
Syrian Archive	None	1	#N/A
Tactical Technology Collective	Grantees	5	Europe
Tails	Grantees	5	#N/A
Tatoeba	Grantees	5	#N/A
Tech for Good	Open leaders	3	Europe
Tech Kids Unlimited	Grantees	5	North America
TEDIC NGO	OWF Host Org Applicants	2	South America
TES Global	Mozfest Facilitator	3	Europe
Thai Netizen Network	None	1	Asia
the battle for the net coalition	None	1	#N/A
the center for humane technology	None	1	North America
The Document Foundation	None	1	Europe
The Educational Video Center	Grantees	5	North America
The Educational Video Center	Open leaders	3	North America
The Educational Video Center	Mozfest Facilitator	3	North America
The Engine Room	IHR Contributors	4	#N/A
The Enterprise Center	Grantees	5	North America
The Intern	Grantees	5	#N/A
The Kansas University Endowment Association	Grantees	5	North America
The Knowledge House	Grantees	5	North America
The LAMP	Grantees	5	North America
The New School	Open leaders	3	North America
The Online Progressive Engagement Network	OWF Host Org Applicants	2	#N/A
THE POINT CDC	Grantees	5	North America
The Public Education Foundation - Chattanooga, TN	Mozfest Facilitator	3	North America
The Restart Project	Mozfest Speakers	4	Europe
The Rockefelller Foundation	Funders	5	North America
the slower internet	None	1	#N/A
The Software Sustainability Institute	Mozfest Facilitator	3	Europe
The Tor Project, Inc	Grantees	5	North America
The Trust for Public Land	Open leaders	3	North America
The Urban Farming Guys	Grantees	5	North America
The Womanity Foundation	None	1	Europe
Theatre Action Project	Grantees	5	North America
tibet action institutue	None	1	Asia
Tidelift	IHR Contributors	4	North America
Tirami Ltd	Mozfest Facilitator	3	Europe
Toledo-Lucas County Public Library	Grantees	5	North America
Tribeca Film Institute	Grantees	5	North America
Trinity Animation Inc.	Grantees	5	North America
Trustees of Princeton University	Grantees	5	North America
Turkey Blocks	None	1	Asia
Ubiquity Press	Open leaders	3	Europe
UK Youth	Mozfest Facilitator	3	Europe
United Nations Office for Outer Space Affairs	Open leaders	3	Europe
University of Dundee, Open IoT Studio	Grantees	5	Europe
University of Nottingham, Horizon Digital Economy Research institute	Mozfest Facilitator	3	Europe
Unverzagt von Have	None	1	Europe
Urban Arts	Grantees	5	North America
Urgent Action Fund for Women's Human Rights	None	1	North America
US State Department - Internet Freedom	None	1	North America
Ushahidi	Grantees	5	Africa
ViatoR VR LLC	Grantees	5	North America
Vibe Arts	Grantees	5	North America
Visions of Science Network for Learning	Grantees	5	North America
Visual Thinkery	Mozfest Facilitator	3	Europe
Visualizing Impact	OWF Host Org Applicants	2	North America
Voices for Interactive Choice & Empowerment	None	1	Asia
Vubble	Mozfest Facilitator	3	North America
Wallace Global Fund	None	1	North America
We Are Open Co-op	Mozfest Facilitator	3	#N/A
Web Networks	None	1	North America
webpack	Grantees	5	#N/A
WGBH	Open leaders	3	North America
White Market Podcast	Mozfest Facilitator	3	Europe
White Market Podcast	Open leaders	3	Europe
Whose Knowledge	Mozfest Speakers	4	North America
Wikimedia Foundation	Mozfest Facilitator	3	North America
Wikimedia Foundation	Mozfest Speakers	4	North America
Wikimedia Foundation	Open leaders	3	North America
Wikimedia Foundation	OWF Host Org Applicants	2	North America
Wikimedia France	None	1	Europe
Wikimedia Germany	None	1	Europe
WikiPathways	Open leaders	3	North America
Wild Tree Tech	Open leaders	3	Europe
Wildlife Conservation Society	Grantees	5	North America
Willie Mae Rock Camp for Girls	Grantees	5	North America
Willoughby-Eastlake Public Library	Grantees	5	North America
WITNESS	None	1	North America
Women of Uganda Network	None	1	Africa
Women'sNet	None	1	Africa
World Economic Forum (WEF) Internet for All	None	1	Europe
World Intellectual Property Organization	None	1	Europe
World Wide Web Consortium	None	1	North America
World Wide Web Foundation	IHR Contributors	4	North America
World Wide Web Foundation	Mozfest Speakers	4	North America
World Wide Web Foundation	Mozfest Facilitator	3	North America
WorldBrain.io	Open leaders	3	Europe
Youth Empowering Parents	Grantees	5	North America
YWCA Toronto	Grantees	5	North America
Zenzeleni Networks	None	1	Africa
